Gs^Fp, Gs^Fp, Gs^Fp, Gs^Fp, Gg, Gg, Hh, Mm, Hh, Hh, Ha, Ha, Ai, Ha, Ai, Ww, Ww, Ww, Mm, Mm, Ww, Ww
Gs^Fp, Gs^Fp, Gs^Fp, Gg, Gg, Gg, Hh, Hh, Hh, Hh, Ha, Ha, Ai, Ai, Ww, Ww, Ww, Mm, Mm, Mm, Mm, Hh
Hh, Gg, Gg, Gg, Gg, Gg, Gg, Hh, Mm, Mm, Mm, Hh, Hh, Gg, Ww, Ww, Ww, Ww, Ww, Hh, Hh, Hh
Hh, Hh, Gg, Ch, Ch, Ch, Rr, Hh, Hh, Mm, Hh, Hh, Hh, Gg^Vh, Ww, Ww, Ww, Mm^Vhh, Mm, Hh, Hh, Hh
Hh, Hh, Gg, Ch, 1 Kh, Ch, Gg^Vh, Rr, Hh, Hh, Hh, Gg, Gg, Ww, Ww, Ww, Ww, Hh, Hh, Hh, Hh, Gs^Fp
Hh, Hh, Ch, Ch, Ch, Gg, Gg, Rr, Rr, Gg, Gg, Hh, Ww, Ww, Ww, Ww, Ww, Hh, Gs^Fp, Hh, Gg, Gg
Ha, Hh, Gg, Gg, Gg, Gg, Gg, Gg, Rr, Gg, Gg, Gg, Ww, Ww, Ww, Ww, Gs^Fp, Gs^Fp, Gs^Fp, Gg, Gg, Gg
Hh, Hh, Gg, Gg, Gg, Gg, Gg, Gg, Aa, Rr, Gg, Gg, Ww, Ww, Ww, Ww, Ww, Gg, Gg, Gs^Fp, Gg, Gg
Gg, Gg^Vh, Gg, Gg, Gg, Gg, Gg, Gg, Gg, Rr, Rr, Gg, Gg^Vh, Ww, Ww, Ww, Gg^Vh, Gg, Gg, Gg, Gs^Fp, Gg
Gg, Gg, Gg, Gs^Fp, Gs^Fp, Gg, Gg, Gg, Gg, Gg, Gg, Rr, Rr, Ww, Ww, Gs^Fp, Gs^Fp, Gg, Gg, Gg, Gs^Fp, Gg
Rr, Gg, Gg, Gs^Fp, Gg^Ve, Gs^Fp, Gg, Gg, Gg, Gg, Hh, Hh, Hh, Rr, Gg, Gg, Gs^Fp, Gg, Gg, Gg, Gs^Fp, Gg
Gg, Gs^Fp, Gg, Gs^Fp, Gs^Fp, Gs^Fp, Gs^Fp, Gg, Hh, Ha, Ha, Ha, Ha, Rr, Rr, Gg, Gg, Gs^Fp, Gs^Fp, Gg, Gg, Gg
Gg, Gg, Gg, Gg, Gs^Fp, Gs^Fp, Gs^Fp, Hh, Mm, Mm, Mm, Ha, Ha, Gg, Rr, Gg, Gg, Gg, Gg, Gg, Gg, Gg
Gs^Fp, Gg, Gg, Gg, Gg, Hh, Hh, Mm, Mm, Mm, Mm, Mm, Hh, Gg, Rr, Gg, Gg, Gg, Gg, Gg, Gg, Gg
Gs^Fp, Gs^Fp, Gg, Gg, Gg, Hh, Mm, Mm, Mm^Vhh, Ww, Ww, Ww, Ww, Ww, Gs^Fp, Ch, Ch, Ch, Gg, Gg, Gg, Gg
Gg, Gg, Gg, Gg, Gg, Hh, Mm, Ww, Ww, Ww, Ww, Ww, Ww, Gg, Gg, Ch, 2 Kh, Ch, Gg, Gg, Hh, Hh
Rr, Rr, Rr, Gg, Gg, Aa, Hh, Ww, Ww, Ww, Ww, Ww, Ww, Gg, Ch, Ch, Ch, Gs^Fp, Gg^Vh, Hh, Hh, Hh
Rr, Gg, Gg, Rr, Rr, Gg, Ww, Ww, Ww, Ww, Ww, Ww, Ww, Ww, Ds, Gg, Ss, Gs^Fp, Rr, Rr, Rr, Hh
Aa, Aa, Gg, Gg, Gg, Rr, Rr, Gg^Vh, Ww, Ww, Ch, Gs^Fp, Rr, Gg, Ds, Gg, Rr, Rr, Gg, Hh, Mm, Rr
Aa, Rr, Rr, Gg, Gg, Gg, Gg, Rr, Rr, Rr, Ww, Rr, Gs^Fp, Rr, Rr, Rr, Gg, Gs^Fp, Gg, Hh, Mm, Ha
Gg, Gg, Gg^Vh, Rr, Rr, Gs^Fp, Rr, Gg, Gg, Ds, Ds, Gg, Gs^Fp, Gs^Fp, Gg, Gg, Gg, Gs^Fp, Hh, Hh, Hh, Hh
Gg, Hh, Gg, Gg, Gg, Rr, Gs^Fp, Rr, Rr, Rr, Ds, Gs^Fp, Gs^Fp, Gs^Fp, Gs^Fp, Gs^Fp, Gs^Fp, Gs^Fp, Hh, Hh, Mm, Gg
